NO ./path_to_the_north_texture       df
SO ./path_to_the_south_texture
WE ./path_to_the_west_texture
EA ./path_to_the_east_texture
F 220, 100 , 0, 23
C 225, 34 ,0

1111111111111111111111111
1000000000110000000000001
1011000001110000000000001
1001000000000000000000001
1000000000000000000000001
10000W0000000000000000001
1111111111111111111111111
