NO ./path_to_the_north_texture
SO ./path_to_the_south_texture
WE ./path_to_the_west_texture
EA ./path_to_the_east_texture
F 220,100,0
C 225,30,0       

11111111111111111111111111111
100N01010001010000011000010001
110001000000001010010000011101
111000001000110000000010000001
100010010001010010001000001001
100000011100101000000010001001
100001010001000000100000000111
100000010000000100010011100001
100011001100000000000100001011
100001011010000001000001100101
110000000000100010000111011001
111001010000000000001010011001
110000100000000001000010001011
101001000001000000100000000001
100000000100000110001001011001
101001010000000001000000000111
110101100100001000010101010101
100000000100100010000000010001
100100000000111011110100001001
111111111111111111111111111111