NO ./textures/redbrick.xpm
SO ./textures/colorstone.xpm
WE ./textures/north.xpm 
EA ./textures/wood.xpm
F 110,100,0
C 115,30,0    

        1111111111111111111111111
        1000000000110000000000001
        1011000001110000000000001
        1001000000000000000000001
111111111011000001110000000000001
1000000000110000011101111011111111
11110111111111011100000010001
11110111111111011101010010001
11000000110101011100000010001
10000000000000001100000010001
10000000000000001101010010001
11000001110101011111011110N0111
11110111 1110101 101111010001
11111111 1111111 111111111111