C       200,100,0  
NO ./path_to_the_north_texture       
SO    ./path_to_the_south_texture
WE ./path_to_t\\n\he_west_texture
EA ./path_to_the_east_texture
F       225,30,0        

11111111111111111111
10000000000000000001
10000000000000000001
10000010101010101001
10000000000000000001
10000000000000000001
10000000000000000101
10000000000001010001
10000000000000000101
10000000000000000001
10000000000000000001
10000000000000000001
11111111111111111111