C       200,100,0  
NO ./path_to_the_north_texture       
SO    ./path_to_the_south_texture
WE ./path_to_t\\n\he_west_texture
EA ./path_to_the_east_texture
F       225,30,0        

1111111111111111111111111
1000000000110000000000001
1011000001110000000000001
1001000000000000000000001
1111111110110000011100001
1000000000110000011101111
1111011111111101110000001
1111011111111101110101001
1100000011010101110000001
100000N000000000110000001
1000000000000000110101001
1100000111010101111101101
1111011111101011011110101
1111111111111111111111111