C       200,100,0  
NO ./path_to_the_north_texture       
SO    ./path_to_the_south_texture
WE ./path_to_t\\n\he_west_texture
EA ./path_to_the_east_texture
F       225,30,0        

1111111111111111111111111
1000000000000000000000001
1000101010101010101010101
1000101010101010101010101
1000101010101010101010101
1000101010101010101010101
1000101000001000001010101
1000101000010100001010101
1000101000001000001010101
1000101010101010101010101
1000101010101010101010101
1000101010101010101010101
1000101010101010101010101
1111111111111111111111111