        NO ./path_to_the_north_texture                    
SO ./path_to_the_south_texture
WE ./path_to_the_west_texture
EA ./path_to_the_east_texture
C 225, 34 ,0   
C 225, 34 ,0



111111111111 111111111111111
100000000011 110000000000001
101100000111 110000000000001
111111111111 111111111111111
111111111111 111111111111111
10000W000001 100000000000001
111111111111 111111111111111
