NO ./textures/redbrick.xpm
SO ./textures/colorstone.xpm
WE ./textures/north.xpm
EA ./textures/wood.xpm
F 110,100,0
C 120,30,90


                                      111
                                     10001
        11111111111111111111          101           11111111111111111111
    111100000000000000000000111111111110111111111111000000000000000000001111
11110000000000000S00000000000000000000000000000000000000000000000000000000001111
    111100000000000000000000111111111100011111111111000000000000000000001111
        11111111101111111111          101           11111111101111111111
                101                   101                   101
                101                   101                   101
                101                   101                   101
             111101111                101                111101111
            10000000001               101               10000000001
             111101111                101                111101111
                101                   101                   101
                101                   101                   101
                101                   101                   101
                1001111111111111111111101111111111111111111100111111111111111111111111111111111111111111111111111111111111111111111111111111111111111
                1000000000000000000000000000000000000000000000000000000000000000000000000000000000000000000000000000000000000000000000000000000000011
                 1111111111111111111111011111111111111111111111111111111111111111111111111111111111111111111111111111111111111111111111111111111111111
                                      101
                                      101
                                      101
                                      101
                                     11011
                                    1000001
                                     11011
                                      101
                                      111